6,6,6,6,6,6,6,6,6,6,2,2,2
6,0,0,0,0,0,0,0,0,0,0,2,2
6,0,0,0,0,0,0,0,0,0,0,0,6
6,0,0,0,1,1,1,0,0,0,0,0,6
6,0,0,0,0,0,0,0,0,0,0,0,6
6,0,0,0,0,6,0,0,6,6,0,0,6
6,0,0,0,6,6,0,0,0,0,3,0,6
4,0,0,0,6,6,0,0,0,4,4,0,6
4,4,0,0,0,0,0,0,0,0,0,0,6
6,0,4,0,0,0,0,0,0,0,0,6,6
6,6,6,4,6,6,0,0,6,6,6,6,6
6,6,6,6,6,6,0,0,6,6,2,2,2
6,0,0,0,0,0,0,0,0,0,0,2,3
6,0,0,0,0,0,0,0,3,0,0,0,3
6,0,0,0,1,1,1,0,0,0,0,0,3
6,0,0,0,0,0,0,0,0,0,0,0,6
6,0,0,0,0,6,0,0,6,6,0,0,6
6,0,0,0,6,6,0,0,5,5,5,0,6
4,0,0,0,6,6,0,0,0,4,4,0,6
4,4,0,0,0,0,0,0,0,0,0,0,6
6,0,4,0,0,0,0,0,0,0,0,6,6
6,6,6,4,6,6,6,6,6,6,6,6,6
